4,4,4,4,4,4,4,4,4,1,6,4,4,4,4,4,4,4,4,4,4,4,4,4,4,4,4,4,4,4,4,4,4,4,4,4,4,4,4,4,4,4,4,4,4,4,4,4,4,4,2,4,4,15,8,0,6,12,1,0,5,4,2,4,1,4,4,4,4,4,4,4,4,4,4,4,4,4,4,4,4,4,4,4,4,4,4,4,4,4,4,4,4,4,4,4,4,4,4,4,4,4,4,4,2,4,4,4,4,4,4,4,4,4,4,4,4,4,4,4
4,4,4,4,4,4,4,4,6,4,4,4,4,4,4,4,4,4,4,4,4,4,4,4,4,4,4,4,4,4,4,4,4,4,4,4,4,4,4,4,4,4,4,4,4,4,4,4,4,4,4,4,4,4,4,5,4,4,4,4,4,4,4,4,4,14,8,5,7,2,4,4,4,4,4,4,4,4,4,4,4,4,4,4,4,4,4,4,4,4,4,4,4,4,4,4,4,4,4,4,4,4,4,4,4,6,4,4,4,4,4,4,4,4,4,4,4,4,4,4
4,4,4,4,4,4,4,4,14,4,4,4,4,4,4,4,4,4,4,4,4,4,4,4,4,4,4,4,4,4,4,4,4,4,4,4,4,4,4,4,4,4,4,4,4,4,4,4,13,4,4,4,4,4,4,4,4,4,4,4,4,4,4,4,4,4,4,4,4,4,6,7,4,15,4,0,4,13,4,4,4,4,4,4,4,4,4,4,4,4,4,4,4,4,4,4,4,4,4,4,4,4,2,8,4,4,2,4,4,4,4,4,4,4,4,4,4,4,4,4
4,4,4,4,4,4,4,4,10,11,4,5,2,0,4,5,2,13,2,4,0,4,7,5,4,4,4,4,4,4,4,4,4,4,4,4,4,4,4,4,4,4,4,4,4,4,4,4,0,4,4,4,4,4,4,5,4,4,4,4,4,4,4,4,4,4,4,4,4,4,4,4,4,4,4,4,4,4,13,4,5,5,4,4,4,4,4,4,4,4,4,4,4,4,4,4,4,4,4,4,4,4,1,3,8,12,3,4,4,4,4,4,4,4,4,4,4,4,4,4
4,4,4,4,4,4,4,4,4,4,4,4,4,4,4,4,4,4,4,4,4,4,4,4,4,0,10,1,4,4,5,7,4,7,3,7,5,7,6,0,1,6,2,4,4,4,4,0,4,4,4,4,4,4,4,6,4,4,4,4,4,4,4,4,4,4,4,4,4,4,4,4,4,4,4,4,4,4,4,4,4,4,3,1,6,12,1,3,4,4,4,4,4,4,4,4,0,7,6,0,8,3,4,4,4,4,2,2,3,4,4,4,4,4,4,4,4,4,4,4
4,4,4,4,4,4,4,4,4,5,4,4,4,4,4,4,4,4,4,4,4,5,7,7,3,5,5,2,7,7,7,4,5,3,7,12,6,12,0,5,3,5,6,4,14,4,2,4,4,4,4,4,4,4,4,3,4,4,4,4,4,4,4,4,4,4,4,4,4,4,5,4,4,4,4,4,4,4,4,4,4,4,4,4,4,4,4,4,1,4,3,4,2,5,10,4,2,3,4,4,4,3,4,4,4,4,4,4,4,6,4,4,4,4,4,4,4,4,4,4
4,4,4,4,4,4,4,4,4,2,4,4,4,4,4,4,4,4,0,2,1,4,4,4,4,4,4,4,4,4,4,4,4,4,4,4,4,4,4,4,4,4,4,4,4,12,4,4,4,4,4,4,4,4,4,5,4,4,4,4,4,4,4,4,4,4,4,4,4,0,12,4,4,4,4,4,4,4,4,4,4,4,4,4,4,4,4,0,5,0,4,3,13,4,4,4,7,4,4,4,5,4,4,4,4,4,4,10,4,4,15,4,4,4,4,4,4,4,4,4
4,4,4,4,4,4,4,4,4,8,4,4,4,4,4,4,4,5,1,6,1,1,3,3,0,14,8,11,7,3,7,3,4,4,4,4,4,4,4,4,4,4,4,4,2,4,4,4,4,4,4,4,4,4,4,5,4,4,4,4,4,4,4,4,4,4,4,4,4,4,7,4,4,4,4,4,4,4,4,4,4,4,4,4,4,5,4,4,4,4,4,4,4,4,4,15,4,4,4,7,4,4,4,4,4,4,4,2,4,4,4,0,4,4,4,4,4,4,4,4
4,4,4,4,4,4,4,4,4,5,4,4,4,4,4,4,4,4,4,4,4,4,4,4,4,4,4,4,4,4,4,4,4,6,10,6,0,11,4,4,4,4,4,6,4,4,4,4,4,4,4,4,4,4,4,5,4,4,4,4,4,4,4,11,1,1,1,7,14,4,7,4,4,4,4,4,4,4,4,4,3,6,5,1,7,4,4,4,4,4,4,4,4,4,4,1,4,4,0,4,4,4,4,4,4,4,4,0,4,4,4,0,4,4,4,4,4,4,4,5
4,4,4,4,4,4,4,4,0,2,4,4,4,4,4,4,4,4,4,4,4,4,4,4,4,4,4,4,4,4,7,5,7,11,0,0,4,0,4,4,4,4,4,4,4,4,4,4,4,4,4,4,4,4,4,2,4,4,4,4,4,4,0,4,4,4,4,2,4,4,3,4,4,4,4,4,4,4,3,7,8,11,4,4,0,4,4,4,4,4,4,4,4,4,6,4,4,8,4,4,4,4,4,4,4,4,4,1,4,4,4,4,0,4,4,4,4,4,4,7
4,4,4,4,4,4,4,4,4,4,4,4,4,4,4,4,4,4,4,4,4,14,4,4,4,4,4,4,5,3,4,4,4,4,4,4,7,4,5,13,5,7,4,4,4,4,4,5,7,4,4,4,4,4,4,6,4,4,4,4,4,6,4,4,4,4,4,8,13,4,4,0,4,4,4,4,4,14,6,2,4,4,4,4,4,4,4,4,4,4,4,4,4,4,0,6,5,4,4,4,4,4,4,4,4,4,4,13,4,4,4,4,3,4,4,4,4,4,3,4
4,4,4,4,4,4,4,4,3,7,4,4,4,4,4,4,4,4,4,4,1,2,4,4,4,9,6,4,4,4,4,4,4,4,4,4,4,0,4,7,11,4,4,4,4,3,7,1,4,4,4,4,4,4,4,7,4,4,4,4,1,4,4,4,4,4,5,1,4,4,4,5,4,4,4,4,4,7,10,4,4,4,4,4,2,4,4,4,4,4,4,4,4,1,4,4,4,4,4,4,4,4,4,3,4,4,4,14,4,4,4,4,9,4,4,4,4,4,3,4
4,4,4,4,4,4,4,5,4,4,4,4,4,4,4,4,4,4,4,4,8,4,4,4,11,7,4,4,4,4,4,4,4,4,4,4,6,4,4,4,4,4,4,4,7,4,4,3,4,4,4,4,4,4,4,2,4,4,4,4,0,4,4,4,4,2,2,4,4,4,4,1,4,4,4,4,4,4,4,4,4,4,4,4,6,4,4,4,4,4,4,4,6,4,11,4,4,4,4,4,5,13,0,6,4,4,4,2,4,4,4,4,6,4,4,4,4,3,4,4
4,4,4,4,4,4,4,0,4,5,4,4,4,4,4,4,4,4,4,2,4,2,4,1,4,4,4,4,4,4,4,4,4,4,4,4,5,4,4,4,4,4,4,14,4,4,4,8,4,4,4,4,4,4,4,4,4,4,4,4,2,4,4,4,4,13,11,4,4,4,4,5,4,4,4,4,4,4,4,4,4,4,4,6,4,4,4,4,4,4,4,4,6,4,4,6,7,12,2,0,1,4,4,10,4,4,4,5,4,4,4,4,0,4,4,4,7,4,4,5
4,4,4,4,4,4,4,3,4,1,4,4,4,4,4,4,4,4,6,4,4,4,3,4,4,4,4,4,4,4,4,4,4,4,4,4,13,4,4,4,4,4,1,4,4,4,4,0,4,4,4,4,4,4,4,3,4,4,4,4,12,4,4,4,0,4,9,4,4,4,4,2,4,4,4,4,4,4,4,4,4,4,4,6,4,4,4,4,4,4,4,9,4,4,11,2,4,0,4,4,4,4,4,4,15,4,4,4,4,4,4,4,4,3,4,1,4,4,4,0
4,4,4,4,4,4,4,4,4,14,4,4,4,4,4,4,4,4,2,4,4,6,0,10,4,4,4,4,4,4,4,4,4,4,4,2,4,4,4,4,9,4,4,4,4,4,12,4,4,4,4,4,4,4,4,9,4,4,4,4,6,4,4,4,0,4,4,4,4,4,4,9,4,4,4,4,4,4,4,4,4,4,4,11,4,4,4,4,4,4,2,4,4,4,7,5,5,4,4,4,4,4,4,4,5,4,4,4,4,4,4,4,4,4,1,4,4,4,4,1
4,4,4,4,4,4,7,4,4,3,4,4,4,4,4,4,4,7,4,4,4,0,4,4,4,4,4,4,4,4,4,4,4,4,4,5,4,4,4,4,4,4,4,4,4,6,4,4,4,4,4,4,4,4,4,10,4,4,4,4,6,4,4,1,4,7,4,4,4,4,4,1,4,4,4,4,4,4,4,4,4,7,4,15,4,4,4,4,4,2,7,7,1,4,3,4,4,4,3,4,4,4,4,4,1,4,15,4,4,4,4,4,6,1,4,4,4,4,4,3
4,4,4,4,4,4,12,4,4,1,4,4,4,4,4,4,1,4,4,4,4,1,4,4,4,4,4,4,4,4,4,4,4,4,0,4,4,6,0,4,4,4,4,4,4,4,4,4,4,4,4,4,4,4,4,3,4,4,4,4,13,4,6,4,4,5,4,4,4,4,4,4,4,4,4,4,4,4,4,4,4,0,4,1,2,4,0,5,5,6,4,4,4,7,4,4,4,4,11,4,4,4,4,4,4,4,2,4,4,4,1,6,4,4,4,4,4,4,4,3
4,4,4,4,4,4,1,4,4,3,4,4,4,4,4,3,4,4,4,4,6,4,4,4,4,3,4,4,4,4,4,4,4,4,3,4,4,14,4,4,4,4,4,4,0,4,4,4,4,4,4,4,4,4,4,1,4,4,4,4,15,4,4,4,5,4,4,4,4,4,4,1,4,4,4,4,4,4,4,4,4,5,4,4,4,4,4,4,4,7,4,4,4,3,4,4,4,4,4,4,4,4,4,4,7,4,12,4,10,6,4,4,4,15,4,4,4,4,7,4
4,4,4,4,4,4,0,4,4,7,4,4,4,4,5,4,4,4,4,7,4,4,4,4,4,4,1,4,4,4,4,4,4,4,0,4,4,0,4,4,4,4,4,4,6,4,4,4,4,4,4,4,4,4,4,4,4,4,4,4,1,3,4,4,7,4,4,4,4,4,4,7,4,4,4,4,4,4,4,4,4,1,4,4,4,4,4,4,2,4,4,4,4,5,4,4,4,4,3,4,4,4,4,4,0,4,10,15,4,4,4,4,4,4,14,4,4,4,4,4
4,4,4,4,4,8,4,4,4,0,4,4,4,3,4,4,4,4,4,0,4,4,4,4,4,4,0,4,4,4,4,4,4,2,4,4,4,4,4,4,4,4,4,6,4,4,4,4,4,4,4,4,4,4,4,1,4,4,4,4,15,7,4,2,4,4,4,4,4,4,4,4,4,4,4,4,4,4,4,4,5,4,4,4,4,10,4,4,3,4,4,4,4,11,4,4,4,4,3,4,4,4,4,4,4,3,4,4,4,4,4,4,4,4,4,4,4,3,4,4
4,4,4,4,4,7,4,4,4,0,4,4,5,4,12,5,5,4,4,3,4,4,4,4,4,1,6,6,13,7,1,4,13,11,10,1,2,4,4,4,7,4,4,14,4,4,4,4,4,4,4,4,4,4,4,2,4,4,4,4,6,4,5,4,4,4,4,4,4,4,4,4,4,4,4,2,4,5,5,5,1,7,2,1,6,2,5,9,4,4,4,4,15,4,4,4,4,4,3,4,4,4,4,4,4,1,4,4,4,4,4,4,4,4,0,4,4,3,4,4
4,4,4,4,4,8,4,4,4,1,4,0,4,4,3,4,4,8,7,4,4,4,4,4,3,3,4,4,1,4,4,4,9,4,4,4,4,12,15,6,5,3,6,9,2,4,4,4,4,4,4,4,4,4,4,6,4,4,4,4,3,5,4,4,4,1,13,4,4,1,8,2,7,14,2,4,4,4,4,4,12,3,4,3,4,4,4,9,7,2,2,4,6,4,11,9,2,6,5,4,4,4,4,4,4,9,4,4,4,4,4,4,4,4,3,3,4,4,4,4
4,4,4,4,6,4,4,4,4,4,4,4,4,4,3,4,4,5,4,4,4,4,4,4,3,7,4,4,15,4,4,0,4,4,4,4,4,4,4,4,4,4,0,4,4,7,4,15,3,1,1,14,5,11,4,7,1,0,5,1,7,4,4,7,14,6,6,3,7,4,4,0,4,4,4,4,4,4,4,4,4,5,1,4,4,4,4,1,4,4,4,4,1,4,4,4,4,4,4,4,4,4,4,4,4,6,4,4,4,4,4,4,4,4,4,4,4,4,4,4
4,4,4,4,3,4,4,4,4,7,4,4,4,3,4,4,4,14,7,4,4,4,4,1,1,1,4,4,4,3,5,4,4,4,4,4,4,4,4,4,4,6,4,4,4,4,4,11,7,4,4,4,4,4,4,0,4,4,1,4,13,14,13,1,1,4,7,4,4,4,4,0,4,4,4,4,4,4,4,4,1,5,4,4,4,4,7,4,4,4,4,15,4,4,4,4,4,4,4,4,4,4,4,4,4,7,4,4,4,4,4,4,4,4,4,4,4,4,4,4
4,4,4,4,4,4,4,4,4,4,4,4,4,4,4,4,4,0,6,4,4,4,0,4,5,0,4,4,4,4,4,4,4,4,4,4,4,4,4,4,11,4,4,4,4,4,4,4,0,4,4,4,4,4,4,3,4,4,2,14,1,2,4,4,4,4,5,4,4,4,4,6,4,4,4,4,4,4,4,1,3,2,4,4,4,4,11,4,4,4,4,4,4,4,4,4,4,4,4,4,4,4,4,4,4,5,4,4,4,4,4,4,4,4,4,4,4,4,4,4
4,4,4,4,3,4,4,4,4,4,4,4,4,11,4,4,4,4,13,4,4,4,4,4,1,4,4,4,4,9,4,15,4,4,4,4,4,4,4,3,4,4,4,4,4,4,4,4,1,4,4,4,4,4,4,5,4,6,2,5,4,2,4,4,4,6,4,4,4,4,4,5,4,4,4,4,4,4,4,13,4,4,4,4,4,1,4,4,4,4,4,6,4,4,4,4,4,4,4,4,4,4,4,4,1,0,4,4,4,4,4,4,4,4,4,4,4,4,4,4
4,4,4,4,4,4,4,4,4,4,4,4,4,1,4,4,4,1,6,4,9,4,4,4,5,4,4,4,8,4,4,2,4,4,4,13,4,4,6,4,4,4,4,4,4,4,4,4,2,4,4,4,4,4,4,2,4,0,4,4,4,2,1,2,1,2,6,5,1,13,12,1,7,7,14,3,2,6,2,14,14,5,7,7,1,7,5,4,3,7,1,15,4,5,8,0,2,1,5,8,6,4,0,5,5,12,4,3,15,13,4,4,4,4,4,4,4,4,4,4
4,4,4,4,5,4,4,4,4,4,4,4,14,4,4,4,3,4,1,0,11,4,4,4,14,14,4,6,4,4,4,4,15,4,4,15,3,4,4,4,4,4,4,4,4,4,4,4,13,4,4,4,4,4,4,3,1,4,4,4,4,6,4,4,3,4,4,4,4,4,4,1,4,4,4,4,4,2,0,4,4,5,4,4,4,4,4,4,4,4,4,5,4,3,4,4,4,4,4,4,4,4,4,4,3,6,1,4,4,6,4,5,0,13,1,7,5,7,4,12
4,4,4,4,1,4,4,4,4,4,4,4,6,4,4,5,3,0,4,7,0,3,15,5,0,6,6,4,4,4,4,4,4,0,4,4,7,4,4,4,4,4,4,4,4,4,4,4,10,4,4,4,4,4,4,3,4,4,4,4,4,5,9,4,5,4,4,4,4,4,4,9,4,4,4,4,13,4,1,4,4,1,4,4,7,4,4,4,4,4,7,4,6,3,4,4,4,4,4,4,4,4,4,4,14,4,10,4,4,4,4,4,4,4,4,4,4,4,4,4
4,4,4,10,4,4,4,4,4,1,3,0,5,1,13,11,1,4,15,7,4,4,4,5,6,10,1,4,4,4,4,4,4,5,11,4,4,1,2,14,4,4,4,4,4,4,4,4,5,4,4,4,4,4,4,4,4,4,4,4,4,3,0,4,4,4,4,4,4,4,4,0,4,4,4,4,4,7,4,4,4,14,4,2,4,4,4,4,4,4,4,5,4,11,4,4,4,4,4,4,4,4,4,7,4,3,5,4,4,4,4,4,4,4,4,4,4,4,4,4
4,4,4,1,4,4,4,4,4,4,4,15,5,7,4,4,5,1,2,13,3,4,6,4,4,4,4,6,1,4,4,4,4,4,7,4,5,0,0,7,3,4,4,4,4,4,4,4,3,4,4,4,4,4,4,4,1,7,7,7,0,6,4,0,2,4,4,4,4,4,4,6,4,4,4,7,4,2,4,4,4,6,4,1,4,4,4,4,4,4,8,2,4,4,4,4,4,4,4,4,4,4,4,14,4,5,13,4,4,4,4,4,4,4,4,4,0,4,4,4
4,4,4,0,4,4,4,4,4,4,4,6,4,9,8,1,1,3,4,4,14,4,14,4,4,4,4,4,1,6,4,4,4,7,4,4,12,1,4,6,4,3,0,4,4,4,4,4,5,4,4,4,4,3,5,4,4,4,4,4,0,3,4,0,4,4,4,4,4,4,4,5,4,4,1,4,4,4,4,4,4,6,5,4,4,4,4,4,4,4,3,4,4,5,4,4,4,4,4,4,4,4,2,4,4,2,4,2,4,4,4,4,4,4,4,4,4,4,4,4
4,4,4,0,4,4,4,4,4,4,4,4,4,4,4,0,7,4,4,4,6,4,2,4,4,4,4,4,4,4,6,0,2,4,4,2,6,4,4,4,4,4,12,3,4,4,4,4,3,3,0,2,11,4,4,4,4,4,4,4,2,5,4,4,4,4,4,4,4,4,4,0,4,11,4,4,4,3,4,4,4,3,13,4,4,4,4,4,4,4,4,4,4,4,1,4,4,4,4,4,4,4,1,4,4,4,4,3,4,4,4,4,4,4,4,4,10,4,4,4
4,4,4,1,4,4,4,4,4,4,4,8,4,4,4,4,8,11,4,4,5,4,13,4,4,4,4,4,4,4,4,3,6,2,6,0,4,4,4,1,4,4,4,8,0,4,4,4,3,4,4,4,4,4,4,4,4,4,4,4,3,15,6,4,6,4,4,4,4,4,4,6,13,4,4,4,4,4,4,4,4,1,4,4,4,4,4,4,4,6,4,4,4,4,6,9,4,4,4,4,4,4,4,4,4,7,4,0,4,4,4,4,4,4,4,4,11,4,4,4
4,4,4,5,4,4,4,4,4,4,4,14,4,4,4,4,4,2,4,4,6,1,4,4,4,4,4,4,4,4,4,5,4,5,6,4,4,4,4,15,4,4,4,4,0,12,4,4,4,4,4,4,4,4,4,4,4,4,4,4,0,3,12,4,5,4,4,4,4,4,4,5,0,4,4,4,0,4,4,4,4,14,4,4,4,4,4,4,4,6,4,4,4,4,4,3,4,4,4,4,4,12,4,4,4,6,4,4,2,4,4,4,4,4,4,4,7,4,4,4
4,4,4,3,4,4,4,4,4,4,2,4,4,4,4,4,4,1,4,4,4,5,4,4,4,4,4,4,4,4,2,1,4,4,4,4,4,4,4,4,7,4,4,4,4,3,12,4,4,4,4,4,4,4,4,4,4,4,4,4,7,5,4,4,4,14,4,4,4,4,4,12,4,4,4,4,7,4,4,4,7,5,4,4,4,4,4,4,9,4,4,4,4,4,4,5,1,4,4,4,2,4,4,4,4,1,4,4,4,4,4,4,4,4,4,4,5,4,4,4
4,4,4,3,4,4,4,4,4,4,4,4,4,4,4,4,4,1,4,4,4,5,4,4,4,4,4,4,4,5,9,4,4,4,4,4,4,4,4,4,1,4,4,4,4,4,6,11,4,4,4,4,4,4,4,4,4,4,4,4,2,2,3,4,4,6,4,4,4,7,5,7,4,4,4,4,5,4,7,11,4,1,4,4,4,4,4,1,4,4,4,4,4,4,4,4,4,5,4,4,9,4,4,4,4,1,4,4,5,4,4,4,4,4,4,4,6,4,4,4
4,4,4,2,4,4,4,4,4,4,6,4,4,4,4,4,4,10,4,4,0,0,5,4,4,4,4,7,9,14,4,4,4,4,4,4,4,4,2,0,1,6,13,2,4,4,4,1,4,4,4,4,4,4,4,4,4,4,4,4,1,2,7,4,4,4,13,4,7,4,4,4,4,4,4,4,8,7,4,4,4,3,4,4,4,4,4,12,3,4,4,4,4,4,4,4,4,3,15,3,4,4,4,4,4,0,4,4,4,12,4,4,4,4,4,4,9,4,4,4
4,4,4,1,4,4,4,4,4,2,4,4,4,4,4,4,11,3,4,4,7,4,1,4,4,4,6,3,4,4,4,4,4,4,4,4,4,7,4,7,4,4,4,4,4,4,4,4,0,4,4,4,4,4,4,4,4,4,4,4,2,4,7,4,4,4,4,4,4,4,4,10,4,4,4,5,1,4,4,4,4,3,4,4,4,4,1,13,4,4,4,4,4,4,4,4,4,4,3,0,4,4,4,4,4,5,4,4,4,2,4,4,4,4,4,4,3,4,4,4
4,4,4,3,4,4,4,4,4,1,4,4,4,4,4,8,4,4,4,4,7,4,8,14,1,2,6,4,4,4,4,4,4,4,4,1,1,4,4,0,7,4,4,15,4,4,4,4,7,4,4,4,4,4,4,4,4,4,4,4,7,4,4,4,4,3,3,3,4,4,4,13,4,4,1,15,4,4,4,4,4,12,4,4,4,4,0,4,4,4,4,4,4,4,4,4,4,4,1,7,4,4,4,4,4,0,4,4,4,1,15,4,4,4,4,4,11,4,4,4
4,4,4,11,4,4,4,4,4,1,4,4,4,4,4,7,4,4,4,4,13,4,4,4,4,4,4,4,4,4,4,4,4,4,3,0,4,3,3,14,5,4,4,4,5,4,4,4,15,15,4,4,4,4,4,4,4,4,4,4,4,4,2,4,4,4,4,5,6,2,10,7,10,2,4,3,4,4,4,4,4,0,4,4,4,4,4,4,4,4,4,4,4,4,4,4,4,4,5,4,4,4,0,4,4,6,4,4,4,4,3,4,4,4,4,4,5,4,4,4
4,4,4,3,4,4,4,4,6,4,4,4,4,4,0,4,4,4,4,9,4,4,4,4,4,4,4,4,4,4,4,4,13,3,10,5,6,3,4,7,7,4,4,4,6,4,4,4,4,1,4,4,4,4,4,4,4,4,4,4,4,4,2,3,4,4,4,4,4,4,4,4,4,4,4,4,4,4,4,4,4,12,4,4,4,4,4,4,4,4,4,4,4,4,4,4,4,4,1,4,11,13,1,6,4,7,4,4,4,4,11,4,4,4,4,4,6,4,4,4
4,4,4,0,4,4,4,4,1,4,4,4,4,0,4,4,4,4,4,7,4,4,4,4,4,4,4,4,4,4,4,0,4,9,4,4,4,4,4,4,7,4,4,4,3,4,4,4,4,3,4,4,4,4,4,4,4,4,4,4,4,3,1,4,4,4,4,4,4,4,4,4,4,4,7,4,4,4,4,4,4,4,4,4,4,4,4,4,4,4,4,4,4,4,4,4,4,14,4,4,11,0,4,0,4,5,4,4,4,4,4,2,4,4,4,4,7,4,4,4
4,4,4,0,4,4,4,4,1,4,4,4,4,2,4,4,4,4,2,4,4,4,4,4,4,4,4,1,5,7,0,5,6,2,7,5,4,4,4,4,15,4,4,4,2,4,4,4,4,3,4,4,4,4,4,4,4,4,4,4,15,4,6,4,4,4,4,4,4,4,6,4,4,4,2,4,4,4,4,4,4,11,4,4,4,4,4,4,4,4,4,4,4,4,4,4,4,5,3,0,4,4,4,15,4,15,4,4,4,4,4,15,4,4,4,4,6,4,4,4
4,4,4,6,4,4,4,4,0,4,4,4,4,5,4,4,4,4,6,4,4,4,4,4,4,4,4,4,4,4,4,4,4,4,4,0,7,4,4,4,1,4,4,4,12,4,4,4,4,8,4,4,4,4,4,4,5,4,7,6,4,4,5,4,4,4,4,4,4,4,4,4,4,14,4,4,4,4,4,4,4,1,4,4,4,4,4,4,4,4,4,4,4,4,4,4,4,3,4,4,4,4,7,3,4,5,4,4,4,4,4,9,4,4,4,4,7,4,4,4
4,4,4,5,4,4,4,4,7,4,4,4,2,4,4,4,4,6,0,4,4,4,4,4,4,4,4,4,4,4,4,4,4,4,4,4,1,4,4,4,7,4,4,4,7,4,4,4,4,4,4,4,4,4,4,4,0,5,4,4,4,4,6,4,4,4,4,4,4,4,5,4,4,2,4,4,4,4,4,4,4,11,4,4,4,4,4,4,4,4,4,4,4,4,4,4,9,4,4,4,4,4,11,3,4,15,4,4,4,4,4,4,5,4,4,4,4,4,4,4
4,4,4,5,4,4,4,4,0,4,4,4,7,4,4,4,4,11,4,4,4,4,4,4,4,4,4,4,4,4,4,4,4,4,4,4,5,4,4,4,4,4,1,5,4,4,4,4,5,2,4,4,4,4,4,12,8,3,3,1,4,4,0,4,4,4,4,4,4,4,7,4,4,4,4,4,4,4,4,4,4,1,4,4,4,4,4,4,4,4,4,4,4,4,6,5,4,4,4,4,4,4,4,4,4,1,4,4,4,4,4,4,15,4,4,4,0,4,4,4
4,4,4,12,4,4,4,0,1,4,4,5,7,4,4,4,4,4,4,4,4,4,4,4,4,4,4,4,8,4,4,4,4,4,4,4,2,5,4,4,4,10,0,4,4,4,4,1,1,4,4,4,4,4,0,4,8,0,4,4,6,4,4,2,4,4,4,4,4,7,4,4,13,4,4,4,4,4,4,4,4,5,4,4,4,4,4,4,4,4,10,4,15,13,4,4,4,4,4,4,4,4,3,3,4,8,4,4,4,4,4,4,1,5,4,3,4,4,4,4
4,4,4,4,10,4,4,2,4,4,4,1,4,4,4,4,4,4,4,4,4,4,4,4,4,4,4,4,4,4,4,4,4,4,4,4,4,6,6,3,3,2,4,4,4,4,0,4,4,4,4,4,7,0,4,4,3,2,4,4,4,4,4,2,4,4,4,4,4,2,4,4,13,4,4,4,4,4,4,4,4,2,4,4,4,4,4,4,4,5,6,7,4,4,4,4,4,4,4,4,4,4,6,4,4,5,4,4,4,4,4,4,4,1,4,7,15,4,4,4
4,4,4,4,4,4,4,6,4,4,4,4,4,4,4,4,4,4,4,4,4,4,4,4,4,4,4,4,4,4,4,4,4,4,4,4,4,4,7,6,4,4,4,4,4,0,3,4,4,4,4,6,4,4,4,4,11,0,4,4,4,4,0,4,4,4,4,4,4,5,4,4,14,4,4,4,4,4,4,4,4,0,4,4,4,4,4,4,4,0,14,4,4,4,10,4,4,4,4,4,4,6,3,4,7,3,4,4,4,4,4,4,4,5,4,1,6,4,4,8
4,4,4,4,1,4,4,0,4,4,4,1,4,4,4,4,4,4,4,4,4,4,4,4,4,4,4,4,4,4,4,4,4,4,4,4,4,5,11,4,7,1,7,1,2,4,4,4,4,4,5,4,4,4,4,4,4,15,4,4,4,4,4,5,7,4,4,4,4,9,4,4,6,4,4,4,4,4,4,4,4,0,4,4,4,4,4,1,4,2,4,4,4,9,4,4,4,4,4,4,4,0,4,4,2,4,4,4,4,4,4,4,4,6,4,15,8,4,4,2
4,4,4,4,4,4,4,7,4,4,4,11,4,4,4,4,4,4,4,4,4,4,4,4,4,4,4,4,10,1,3,4,4,4,4,4,4,6,4,4,5,4,4,4,4,4,4,4,4,3,4,4,4,4,4,4,1,8,4,4,4,4,4,4,5,9,4,4,4,0,4,4,4,4,4,4,4,4,4,4,4,4,4,4,3,2,3,0,4,7,4,4,6,4,4,4,4,4,4,4,4,1,4,4,3,11,4,4,4,4,4,4,4,7,4,1,2,4,5,4
4,4,4,4,14,4,9,4,4,4,11,3,0,3,14,3,4,4,8,3,7,3,6,1,5,5,9,6,4,4,11,5,15,5,1,1,9,7,4,4,4,4,4,4,4,4,4,4,0,4,4,4,4,4,4,4,15,12,4,4,4,4,4,4,15,4,5,4,4,6,4,4,3,4,4,4,4,4,4,4,4,0,7,5,12,15,4,4,4,7,4,4,3,4,4,4,4,4,4,4,4,5,4,4,0,3,4,4,4,4,4,4,4,4,2,15,15,1,4,4
4,4,4,4,3,4,12,4,4,4,4,4,6,4,4,4,4,4,4,6,15,5,6,7,1,5,7,12,5,5,7,1,4,4,4,4,4,4,4,4,4,4,4,4,4,4,0,1,4,4,4,4,4,4,4,4,6,0,4,4,4,4,4,4,0,4,4,4,0,1,4,3,4,4,4,4,4,4,4,4,1,5,5,1,4,4,4,4,4,0,4,12,4,4,4,4,4,4,4,4,4,0,4,4,10,7,4,4,4,4,4,4,4,4,6,3,7,4,4,4
4,4,4,4,7,4,7,4,4,6,6,4,1,11,4,4,4,4,4,12,4,4,4,4,4,4,4,4,4,4,1,6,4,4,4,4,4,4,4,4,4,4,4,4,4,0,4,4,4,4,4,4,4,4,4,4,15,5,4,4,4,4,4,4,2,4,4,4,4,7,4,0,4,4,4,4,4,4,6,1,4,7,7,4,4,4,4,4,4,8,4,10,4,4,4,4,4,4,4,4,4,8,4,4,4,2,4,4,4,4,4,4,4,4,3,5,6,4,4,4
4,4,4,4,0,4,7,4,4,7,4,4,4,4,12,5,4,4,4,4,5,12,4,4,4,4,4,4,4,4,7,4,2,5,7,6,2,5,4,4,4,4,4,4,7,4,4,4,4,4,4,4,4,4,4,4,1,6,4,4,4,4,4,4,0,4,4,4,4,5,7,10,4,4,4,4,4,5,2,4,4,3,4,4,4,4,4,4,4,3,0,4,4,4,4,4,4,4,4,4,4,4,4,4,4,9,4,4,4,4,4,4,4,4,3,3,5,4,4,4
4,4,4,4,4,11,4,4,7,4,4,4,4,4,4,4,15,2,1,11,8,7,6,4,4,4,4,4,4,4,4,4,2,4,4,4,4,4,2,6,4,14,11,1,4,4,4,4,4,4,4,4,4,4,4,4,3,3,4,4,4,4,4,4,15,4,4,4,4,5,7,11,4,4,4,4,5,7,4,4,4,7,4,4,4,4,4,4,4,4,6,4,4,4,4,4,4,4,4,4,2,4,4,4,4,2,4,4,4,4,4,4,4,4,7,3,4,4,4,4
4,4,4,4,4,4,3,4,5,4,4,4,4,4,4,4,4,4,4,4,4,5,1,6,15,3,4,4,4,4,4,4,4,1,4,4,4,4,4,4,4,4,15,5,7,3,3,9,4,4,4,4,4,4,4,4,4,7,4,4,4,4,4,4,0,4,4,4,4,9,4,4,0,1,4,0,12,7,4,4,8,5,4,4,4,4,4,4,4,6,3,4,4,4,4,4,4,4,4,4,3,4,4,4,4,5,4,4,4,4,4,4,4,4,2,9,4,4,4,4
4,4,4,4,4,4,5,2,4,4,4,4,4,4,4,4,4,4,4,4,4,4,4,4,4,4,4,4,4,4,6,4,4,2,4,4,4,4,4,4,4,10,4,4,4,4,4,9,1,5,6,1,4,4,4,2,1,1,4,4,4,4,4,4,13,4,4,4,4,0,4,4,4,4,7,12,12,0,4,4,7,5,4,4,4,4,4,4,4,0,4,4,4,4,4,4,4,4,4,4,0,4,4,4,4,2,4,4,4,4,4,4,4,11,4,4,4,4,4,4
4,4,4,4,4,10,6,4,4,4,4,4,4,4,4,4,4,4,4,4,4,4,4,4,4,4,4,4,4,4,1,4,4,4,6,4,4,4,4,4,3,4,4,4,4,4,4,4,4,4,4,7,5,4,5,1,4,4,4,4,4,4,4,4,4,0,4,4,4,4,4,4,4,4,4,7,0,4,4,4,0,1,4,4,4,4,4,4,4,11,4,4,4,4,4,4,4,4,4,4,10,4,4,4,4,13,4,4,4,4,4,4,7,4,4,7,4,4,4,4
4,4,4,4,4,4,7,1,4,4,4,4,4,4,4,4,4,4,4,4,4,4,4,4,4,4,4,4,4,4,5,4,4,4,6,4,4,4,4,4,7,4,4,4,4,4,4,4,4,4,4,4,4,4,4,4,1,4,4,4,4,4,4,4,4,7,4,4,4,4,4,4,4,4,4,4,5,4,4,9,4,6,4,4,4,4,4,4,7,4,13,4,4,4,4,4,12,7,4,3,4,4,4,4,4,0,4,4,4,4,4,4,4,4,0,2,4,4,4,4
4,4,4,4,4,12,6,6,4,4,4,4,4,4,4,4,4,4,4,4,4,4,4,4,4,4,4,4,4,4,4,4,4,4,4,2,4,4,4,2,4,4,4,4,4,4,4,4,4,4,4,4,4,4,4,4,2,4,4,4,4,4,4,4,4,4,1,7,5,5,0,13,9,3,14,11,4,3,4,4,4,6,4,4,4,4,4,4,6,4,5,4,2,6,1,4,4,4,3,7,4,4,4,4,4,4,4,4,4,4,4,4,3,4,4,4,4,4,4,4
4,4,4,4,12,4,13,5,4,4,4,4,4,4,4,4,4,4,4,4,4,4,4,4,4,4,4,4,4,4,1,4,4,4,4,3,5,8,8,4,4,4,4,4,4,4,4,4,4,4,4,4,4,4,4,4,4,4,4,4,4,4,4,4,4,4,4,4,4,4,4,4,4,4,4,4,4,4,15,11,4,1,4,4,4,4,4,0,4,4,1,4,7,4,4,4,4,4,3,7,4,4,4,4,4,13,4,4,4,4,4,3,4,4,3,11,4,4,4,4
4,4,4,4,1,4,1,4,4,4,4,4,4,4,4,4,4,4,4,4,4,4,4,4,4,4,4,4,4,4,8,4,4,4,4,4,15,4,4,4,4,4,4,4,4,4,4,4,4,4,4,4,4,4,4,14,7,4,4,4,4,4,4,4,4,4,4,4,4,4,4,4,4,4,4,4,4,4,7,4,3,6,4,4,4,4,4,5,4,4,4,4,4,4,4,4,4,4,15,0,4,4,4,4,4,4,4,4,4,4,4,2,4,4,7,3,4,4,4,4
4,4,4,5,4,4,14,4,6,4,4,4,4,2,4,4,4,4,4,4,4,4,4,4,4,4,4,4,4,4,4,4,4,4,4,8,0,5,4,4,4,4,4,4,4,4,4,4,4,4,4,4,4,4,4,7,4,4,4,4,4,4,4,4,4,4,4,4,4,4,4,4,4,4,4,4,4,5,4,4,4,6,4,4,4,4,4,2,4,4,4,4,4,4,4,4,4,4,4,4,4,4,4,4,4,5,4,4,4,4,2,4,4,4,4,0,4,4,4,4
4,4,4,0,4,4,5,4,4,7,4,4,4,0,4,4,4,4,4,4,4,4,4,4,4,4,4,4,4,4,2,4,4,4,4,3,4,14,4,4,4,4,4,4,4,4,4,4,4,4,4,4,4,4,4,7,4,4,4,4,4,4,4,4,4,4,4,4,4,4,4,4,4,4,4,4,4,6,4,4,4,9,4,10,4,4,2,4,4,4,4,4,4,4,4,4,4,4,4,4,4,4,4,4,4,0,1,4,4,4,14,4,4,4,4,7,4,4,4,4
4,4,5,4,4,4,3,4,4,0,4,4,4,6,4,4,4,4,4,4,4,4,4,4,4,4,4,4,4,4,4,4,4,4,6,4,4,12,8,4,4,4,4,4,4,4,4,4,4,4,4,4,4,4,4,7,9,4,4,4,4,4,5,5,11,3,4,4,4,4,4,4,4,4,4,4,4,2,4,4,4,1,4,4,3,4,3,4,4,4,4,4,4,4,4,4,4,4,4,4,4,4,4,4,4,7,8,4,4,10,4,4,4,4,4,5,4,4,4,4
4,4,4,4,4,4,4,4,4,14,4,4,4,6,4,4,4,4,4,4,4,4,4,4,4,4,4,4,4,4,2,4,4,7,4,4,4,4,0,4,4,4,4,4,4,4,4,4,4,4,4,4,4,4,4,7,7,4,4,4,4,7,7,4,4,7,4,4,3,4,4,4,4,4,4,4,4,9,4,4,4,9,4,4,4,5,3,4,4,4,4,4,4,4,4,4,4,4,4,4,4,4,4,4,4,7,1,4,4,14,4,4,4,4,4,3,4,4,4,4
4,4,11,4,4,4,5,4,4,7,2,4,4,4,4,4,4,4,4,4,4,4,4,4,4,4,4,4,4,4,1,4,6,4,4,4,4,4,14,3,4,4,4,4,4,4,4,4,4,4,4,4,4,4,4,10,12,4,4,4,3,10,4,4,4,2,4,4,7,4,4,4,4,4,4,4,7,4,4,4,4,0,4,4,4,4,2,5,4,4,4,4,4,4,4,4,4,4,4,4,4,4,4,4,4,6,4,4,4,7,4,4,4,4,4,7,4,4,4,4
4,6,4,4,4,4,7,4,4,6,4,4,11,5,4,4,4,4,4,4,4,4,4,4,4,4,4,4,4,4,3,6,13,2,5,3,5,3,8,3,4,4,4,4,4,4,4,4,4,4,4,4,4,4,4,15,11,4,4,4,9,4,4,4,4,1,4,4,12,4,4,4,4,4,4,4,1,4,4,4,4,3,4,4,4,0,4,4,0,4,4,4,4,4,4,4,4,4,4,4,4,4,4,4,4,6,12,4,0,4,4,4,4,4,4,5,4,4,4,4
4,3,4,4,4,4,10,4,4,5,4,9,2,6,4,4,4,4,4,4,4,4,4,4,4,4,4,4,4,3,5,4,4,4,4,4,4,4,4,4,11,4,4,4,4,4,4,4,4,4,4,4,4,4,4,2,2,4,4,6,4,4,4,4,4,0,4,4,4,4,4,4,4,4,4,2,4,4,4,4,4,9,4,4,4,6,4,4,4,6,4,4,4,4,4,4,4,4,4,4,4,4,4,4,4,6,4,4,5,4,4,4,4,4,4,1,4,4,4,4
4,1,4,4,4,4,4,4,6,2,4,4,6,7,4,4,4,4,4,4,4,4,4,4,4,4,4,5,2,4,4,4,4,4,4,4,4,4,4,4,6,4,4,4,4,4,4,4,4,4,4,4,4,4,6,4,3,4,4,5,4,4,4,4,4,2,4,4,1,4,4,4,4,4,4,7,4,4,4,4,4,0,4,4,4,4,4,4,4,4,0,4,4,4,4,4,4,4,4,4,4,4,4,4,4,2,4,6,2,4,4,4,4,4,4,4,4,4,4,4
4,7,4,4,4,4,5,4,7,7,4,4,5,6,4,4,4,4,4,4,4,4,4,4,4,4,5,3,4,4,1,4,4,4,4,4,4,4,4,4,4,5,4,4,4,4,4,4,4,4,4,4,4,4,4,4,7,4,7,4,4,4,4,4,4,1,4,4,7,4,4,4,4,4,2,4,4,4,4,4,4,5,4,4,10,4,4,4,4,4,4,6,9,4,4,4,1,4,4,4,4,4,4,4,4,10,4,0,4,4,4,4,4,4,4,13,4,4,4,4
9,4,4,4,4,4,4,4,6,4,4,4,6,1,4,4,4,4,4,4,4,4,4,4,4,0,7,3,0,4,0,4,4,4,4,4,4,4,4,4,4,4,7,4,4,4,4,4,4,4,4,4,4,4,7,4,2,4,7,4,4,4,4,4,4,1,4,10,2,4,4,4,4,4,4,4,4,4,4,4,4,2,4,6,4,4,4,4,4,4,4,4,4,7,4,3,7,4,4,4,4,4,4,4,4,3,4,3,4,4,4,4,4,4,4,1,4,4,4,4
14,4,4,4,4,7,4,4,5,1,4,4,12,13,4,4,4,4,4,4,4,4,4,4,4,7,4,4,4,4,2,4,4,4,4,4,4,4,4,4,4,4,15,4,4,4,4,4,4,4,4,4,4,4,4,4,3,4,2,4,4,4,4,4,4,3,4,4,4,4,4,4,4,3,4,4,4,4,4,4,4,4,4,7,4,4,4,4,4,4,4,4,4,13,2,4,7,4,4,4,4,4,4,4,4,3,6,13,4,4,4,4,4,1,4,4,4,4,4,4
6,4,4,4,4,1,4,12,4,0,4,4,7,14,4,4,4,4,4,4,4,4,4,4,9,4,14,1,4,4,12,4,4,4,4,4,4,4,4,4,4,4,4,0,4,4,4,4,4,4,4,4,4,4,4,4,4,4,4,4,4,4,4,4,4,0,4,5,4,4,4,4,4,5,4,4,4,4,4,4,4,13,13,4,4,4,4,4,4,4,4,0,6,4,4,10,6,4,4,4,4,4,4,4,4,7,6,2,4,4,4,4,8,0,10,15,4,4,4,4
8,4,4,4,4,0,4,3,4,7,4,4,11,5,6,4,4,4,4,4,4,4,4,0,4,1,3,4,4,4,0,4,4,4,4,4,4,4,4,4,4,4,4,6,4,4,4,4,4,4,4,4,4,4,6,4,0,0,4,4,4,4,4,4,4,14,4,4,4,4,4,4,4,2,4,4,4,4,4,4,4,2,4,4,4,4,4,4,4,4,7,4,4,4,4,4,1,7,4,4,4,4,4,4,4,2,1,6,4,4,4,14,0,4,3,15,4,4,4,4
4,4,4,4,4,6,4,10,4,1,4,4,6,0,4,0,4,4,4,4,4,4,4,3,4,4,13,4,4,4,4,4,4,4,4,4,4,4,4,4,4,4,4,4,7,4,4,4,4,4,4,4,4,0,10,4,8,5,4,4,4,4,4,4,4,5,4,14,4,4,4,4,3,4,4,4,4,4,4,4,4,9,4,4,4,4,4,4,4,14,4,4,4,4,4,4,6,4,6,4,4,4,4,4,4,8,4,4,13,15,7,13,4,4,0,4,4,4,4,4
4,4,4,4,4,8,5,4,4,4,4,4,6,4,4,2,4,4,4,4,4,4,2,5,4,4,0,4,4,4,11,4,4,4,4,4,4,4,4,4,4,4,4,4,8,4,4,4,4,4,4,4,4,3,4,4,9,1,4,4,4,4,4,4,4,4,0,7,1,1,4,4,0,4,4,4,4,4,4,4,4,4,4,4,4,4,4,3,13,4,4,4,4,4,4,4,6,4,4,4,4,4,4,4,4,4,4,4,4,12,4,4,4,4,6,0,4,4,4,4
4,4,4,4,4,1,5,4,4,4,4,4,5,4,4,4,2,4,4,4,4,3,4,3,4,4,1,4,4,4,5,2,12,6,1,10,10,14,7,5,13,13,6,11,2,9,4,4,4,4,4,4,4,1,4,4,0,2,4,4,4,4,4,4,4,4,3,11,15,13,4,6,4,4,4,4,4,4,4,4,4,4,4,4,4,4,2,4,4,4,4,4,4,4,4,6,4,4,4,4,12,4,4,4,4,4,4,4,4,4,4,4,4,4,7,11,4,4,4,4
4,4,4,4,1,4,2,4,4,2,4,4,6,15,4,4,0,4,4,4,4,6,6,4,4,3,4,4,4,4,4,7,12,11,7,10,6,1,5,1,5,4,12,4,4,4,4,4,4,4,4,4,4,13,4,4,4,2,4,4,4,1,6,7,7,0,2,15,4,5,4,13,4,4,4,4,4,4,4,4,4,4,4,4,4,7,4,4,4,4,4,4,4,4,4,3,4,4,4,4,4,0,1,13,4,4,4,4,4,4,4,4,4,4,1,7,4,4,4,4
4,4,4,4,0,4,2,4,4,12,4,4,4,1,4,4,4,13,4,4,15,15,4,4,4,7,4,4,4,4,4,4,4,4,4,4,4,4,4,4,4,4,4,4,4,4,4,4,4,4,4,4,10,5,4,4,4,4,1,0,10,4,4,4,4,4,4,4,4,2,6,4,4,4,4,4,4,4,4,4,4,4,4,4,0,4,4,4,4,4,4,4,4,4,4,5,4,4,4,4,4,10,6,7,4,4,4,4,4,4,4,4,4,4,4,3,4,4,4,4
4,4,4,4,1,4,1,4,4,3,4,4,2,2,4,4,4,5,4,4,7,4,4,4,2,4,4,4,4,4,4,4,4,4,4,4,4,4,4,4,4,4,4,4,4,4,4,4,4,4,4,4,14,4,4,4,1,4,4,4,4,4,4,4,4,4,4,4,4,4,7,4,4,4,4,4,4,4,4,4,4,4,2,0,4,4,4,4,4,4,4,4,4,4,4,13,4,4,4,4,12,4,7,4,12,4,4,4,4,4,4,4,4,4,4,7,4,4,4,4
4,4,4,4,4,4,2,4,4,3,4,4,1,4,4,4,4,4,2,4,6,4,4,4,12,4,4,4,4,4,4,4,4,4,4,4,4,4,4,4,4,4,4,4,4,4,4,4,4,4,4,2,4,4,4,4,0,4,4,4,4,4,4,4,4,4,4,4,4,4,9,4,4,4,4,4,4,4,4,4,4,3,4,4,4,4,4,4,4,4,4,4,4,4,4,4,4,4,1,1,4,1,4,4,4,0,3,4,4,4,4,4,4,4,4,7,4,4,4,4
4,4,4,4,2,4,2,4,4,0,4,4,2,6,4,4,4,4,4,15,4,4,4,6,4,4,4,4,4,4,4,4,4,4,4,4,4,4,4,4,4,4,4,4,4,4,4,4,4,4,4,1,4,4,4,4,2,4,4,4,4,4,4,4,4,4,4,6,4,7,4,4,4,4,4,4,4,4,4,4,15,4,4,4,4,4,4,4,4,4,4,4,4,4,10,4,4,5,4,4,4,0,4,4,4,4,4,4,4,4,4,4,4,4,4,6,4,4,4,4
4,4,4,4,12,4,4,4,4,2,4,4,4,14,4,4,4,4,4,0,4,4,4,2,4,4,4,4,4,4,4,4,4,4,4,4,4,4,4,4,4,4,4,4,4,4,4,4,4,4,4,4,4,4,4,4,4,4,4,4,4,4,4,4,4,4,6,4,4,5,4,4,4,4,4,4,4,4,4,4,2,4,4,4,4,4,4,4,4,4,4,4,4,4,1,4,6,4,4,4,7,4,4,4,4,4,4,4,7,4,4,4,4,4,4,6,4,4,4,4
4,4,4,4,0,4,0,4,4,1,4,4,1,3,4,4,4,4,4,4,5,4,4,0,4,4,4,4,4,4,4,4,4,4,4,4,4,4,4,4,4,4,4,4,4,4,4,4,4,4,2,4,4,4,4,4,7,4,4,4,4,4,4,4,4,4,5,4,4,1,4,4,4,4,4,4,4,4,4,13,4,4,4,4,4,4,4,4,4,4,4,4,4,4,1,6,4,4,4,4,1,4,4,4,4,4,4,4,4,2,4,4,4,4,4,5,4,4,4,4
4,4,4,4,0,4,11,4,4,9,4,4,1,4,4,4,4,4,4,4,4,7,2,4,4,4,4,4,4,4,4,4,4,4,4,4,4,4,4,4,4,4,4,4,4,4,4,4,4,5,4,4,4,4,4,4,11,4,4,4,4,4,4,4,4,6,4,4,4,4,4,4,4,4,4,4,4,4,7,4,4,4,4,4,4,4,4,4,4,4,4,4,4,1,7,4,4,4,4,4,7,4,4,4,4,4,4,4,4,4,14,0,4,4,4,6,4,4,4,4
4,4,4,4,15,2,4,4,0,4,4,4,2,6,4,4,4,4,4,4,4,2,7,4,4,4,4,4,4,4,4,4,4,4,4,4,4,4,4,4,4,4,4,4,4,4,4,4,2,4,4,4,4,4,4,4,5,4,4,4,4,4,4,4,3,4,4,4,2,4,4,4,4,4,4,4,4,4,13,4,4,4,4,4,4,4,4,4,4,4,4,4,12,4,9,4,4,4,4,1,4,4,4,4,4,4,4,4,4,4,4,4,3,4,4,4,4,4,4,4
4,4,4,4,5,4,4,4,0,4,4,4,0,1,4,4,4,4,4,4,4,6,2,4,4,4,4,4,4,4,4,4,4,4,4,4,4,4,4,4,4,4,4,4,4,4,4,4,0,4,4,4,4,4,4,4,2,1,1,6,4,0,0,5,4,6,7,13,2,14,0,5,8,2,13,7,9,7,2,6,6,3,4,6,10,6,2,9,1,7,0,4,11,4,5,6,2,0,1,4,7,6,1,3,0,6,6,6,6,6,2,0,4,6,4,5,4,4,4,4
4,4,4,4,6,0,4,4,0,4,4,4,1,4,2,4,4,4,4,4,4,3,4,8,4,4,4,4,4,4,4,4,4,4,4,4,4,4,4,4,4,4,4,4,4,4,4,7,4,4,4,4,4,4,4,4,4,4,12,7,1,4,4,4,4,4,4,4,4,4,4,4,4,4,4,4,14,4,4,4,4,4,4,4,4,4,4,4,4,4,5,4,4,6,4,4,4,4,4,6,4,4,4,4,4,4,4,4,4,4,4,4,4,4,4,6,4,4,4,4
4,4,4,4,9,7,4,4,6,4,4,4,1,4,6,4,4,4,4,4,10,4,4,4,5,4,4,4,4,4,4,4,4,4,4,4,4,4,4,4,4,4,4,4,4,4,3,4,4,4,4,4,4,4,4,4,15,4,4,4,4,4,4,4,4,4,4,9,4,4,4,4,4,4,4,4,7,4,4,4,4,4,4,4,4,4,4,4,6,6,4,4,4,3,4,4,4,4,4,6,4,4,4,4,4,4,4,4,4,4,4,4,4,4,4,5,4,4,4,4
4,4,4,4,15,14,4,4,7,4,4,4,0,4,15,4,4,4,4,4,1,4,4,4,4,7,4,4,4,4,4,4,4,4,4,4,4,4,4,4,4,4,4,4,4,2,0,4,4,4,4,4,4,4,8,6,4,4,4,4,4,4,4,4,4,4,6,4,4,4,4,4,4,4,4,14,4,4,4,4,4,4,4,4,4,4,0,5,4,4,4,4,4,1,4,4,4,4,4,4,4,4,4,4,4,4,4,4,4,4,4,4,4,4,4,2,4,4,4,4
4,4,4,4,13,6,4,4,0,4,4,4,5,4,2,4,4,4,4,3,4,4,4,4,4,4,0,4,4,4,4,4,4,4,4,4,4,4,4,4,4,4,4,4,2,5,4,4,4,4,4,4,0,7,4,4,4,4,4,4,4,4,4,4,4,5,4,4,4,4,4,4,4,4,4,6,4,4,4,4,4,4,4,4,3,4,4,4,4,4,4,4,10,4,4,4,4,4,12,4,4,4,4,4,4,4,4,4,4,4,4,4,4,4,4,4,4,4,4,4
4,4,4,4,12,5,4,4,10,4,4,4,2,4,4,10,4,4,4,3,4,4,4,4,4,4,4,7,0,4,4,4,4,4,4,4,4,4,4,4,4,4,4,4,3,4,4,4,4,4,7,14,1,4,4,4,4,4,4,4,4,4,4,3,12,7,4,4,4,4,4,4,4,4,2,4,4,4,4,4,4,4,15,3,4,4,4,4,4,4,4,4,2,4,4,4,4,4,2,4,4,4,4,4,4,4,4,4,4,4,4,4,4,4,4,4,4,4,4,4
4,4,4,4,5,15,4,4,4,4,4,4,8,4,4,7,4,4,4,4,4,4,4,4,4,4,4,4,4,6,4,4,4,4,4,4,4,4,4,4,4,4,4,15,4,4,4,4,4,13,4,4,4,4,4,4,4,4,4,4,4,1,2,4,4,4,4,4,4,4,4,4,4,4,3,4,4,4,4,4,4,5,4,4,4,4,4,4,4,4,4,0,4,4,4,4,4,4,5,4,4,4,4,4,4,4,4,4,4,4,4,4,4,4,4,4,4,4,4,4
4,4,4,4,4,3,4,4,2,4,4,4,6,4,4,7,4,4,14,4,4,4,4,4,4,4,4,4,4,4,5,4,4,4,4,4,4,4,4,4,4,4,7,4,4,4,4,4,4,4,4,4,4,4,4,4,4,4,4,4,4,7,4,4,4,4,4,4,4,4,4,4,4,6,4,4,4,4,4,4,11,4,4,2,4,4,4,4,4,4,4,4,4,4,4,4,4,4,5,4,4,4,4,4,4,4,4,4,4,4,4,4,4,4,4,4,4,4,4,4
4,4,4,4,8,4,4,4,5,4,4,4,1,4,4,2,4,7,4,4,4,4,4,4,4,4,4,4,4,4,4,9,4,4,4,4,4,4,4,4,4,7,4,4,4,4,4,4,4,4,4,4,4,4,4,4,4,4,4,4,4,1,4,4,4,4,4,4,4,4,4,4,4,0,4,4,4,4,5,1,4,4,4,13,3,4,4,4,4,4,4,0,4,4,4,4,4,4,9,4,4,4,4,4,4,4,4,4,4,4,4,4,4,4,4,4,4,4,4,4
4,4,4,4,7,4,4,4,11,4,4,4,4,1,4,4,4,6,4,4,4,4,4,4,4,4,4,4,4,4,4,4,7,7,4,4,4,4,4,4,2,9,4,4,4,4,4,4,4,4,4,4,4,4,4,4,4,4,4,4,4,4,14,4,4,4,4,4,4,4,4,4,7,4,4,4,6,5,4,4,4,4,5,4,3,4,4,4,4,4,3,4,4,4,4,4,4,4,6,4,4,4,4,4,4,4,4,4,4,4,4,4,4,4,4,4,4,4,4,0
4,4,4,4,5,4,4,4,0,4,4,4,4,5,4,4,1,4,4,4,4,4,4,4,4,4,4,4,4,4,4,4,4,4,9,4,4,4,4,8,4,4,4,4,4,4,4,4,4,4,4,4,4,4,4,4,4,4,4,4,4,4,6,4,4,4,4,4,4,4,4,1,4,4,4,6,4,4,4,4,4,7,4,4,3,4,4,4,4,4,1,4,4,4,4,4,4,4,1,4,4,4,4,4,4,4,4,4,4,4,4,4,4,4,4,4,4,1,2,4
4,4,4,4,1,4,4,4,2,4,4,4,4,4,4,4,6,4,4,4,4,4,4,4,4,4,4,4,4,4,4,4,4,4,4,4,4,15,6,4,4,4,4,4,4,4,4,4,4,4,4,4,4,4,4,4,4,4,4,4,4,4,6,4,4,4,4,4,4,4,4,4,10,14,4,4,4,4,4,4,1,4,4,14,4,4,4,4,4,4,1,4,4,4,4,4,4,4,8,4,4,4,4,4,4,4,4,4,4,4,4,4,15,0,2,5,11,4,4,4
4,4,4,4,3,4,4,4,0,4,4,4,4,5,4,3,0,4,4,4,4,4,4,4,4,4,4,4,4,4,4,4,4,4,4,4,0,8,4,4,4,4,4,4,4,4,4,4,4,4,4,4,4,4,4,4,4,4,4,4,4,4,0,4,4,4,4,4,4,4,4,4,4,4,4,4,4,4,4,4,4,4,4,0,4,4,4,4,4,10,4,4,4,4,4,4,4,4,7,5,7,10,9,7,7,13,6,5,5,7,2,6,4,4,4,4,4,4,4,4
4,4,4,4,3,4,4,4,0,4,4,4,4,12,4,13,4,4,4,4,4,4,4,4,4,4,4,4,4,4,4,4,4,4,1,0,4,4,1,4,4,4,4,4,4,4,4,4,4,4,4,4,4,4,4,4,4,4,4,4,4,4,8,4,4,4,4,4,4,4,4,4,4,4,4,4,4,4,3,4,4,4,4,13,4,4,4,4,4,6,4,4,4,4,4,4,4,4,4,4,4,4,4,4,4,4,4,4,4,4,4,4,4,4,4,4,4,4,4,4
4,4,4,4,2,4,4,4,10,4,4,4,4,7,6,4,4,8,4,4,4,4,4,4,4,4,4,4,4,4,4,4,4,6,4,4,4,4,4,4,6,4,4,4,4,4,4,4,4,4,4,4,4,4,4,4,4,4,4,4,4,4,4,4,4,4,4,4,4,4,4,4,4,4,4,4,4,3,4,4,4,4,4,5,4,4,4,4,12,4,4,4,4,4,4,4,4,4,4,4,4,4,4,4,4,4,4,4,4,4,4,4,4,4,4,4,4,4,4,4
4,4,4,4,11,4,4,4,3,4,4,4,4,13,4,4,4,4,4,4,4,4,4,4,4,4,4,4,4,4,6,3,3,4,4,0,7,3,1,5,0,2,12,4,4,4,4,4,4,4,4,4,4,4,4,4,4,4,4,4,4,4,13,4,4,4,4,4,4,4,4,4,4,4,4,4,4,8,4,4,4,4,2,4,4,4,4,4,0,4,4,4,4,4,4,4,4,4,4,4,4,4,4,4,4,4,4,4,4,4,4,4,4,4,4,4,4,4,4,4
4,4,4,4,2,4,4,4,0,4,4,4,4,3,2,4,4,4,5,4,4,4,4,4,4,4,4,4,14,0,2,4,4,5,10,5,4,4,4,4,4,4,4,8,1,2,2,5,7,1,4,4,4,4,4,4,4,4,4,4,4,4,5,4,4,4,4,4,4,4,4,4,4,4,4,4,1,4,4,4,4,13,4,4,4,4,4,12,4,4,4,4,4,4,4,4,4,4,4,4,4,4,4,4,4,4,4,4,4,4,4,4,4,4,4,4,4,4,4,4
4,4,4,4,5,4,4,4,1,4,4,4,4,5,5,4,4,4,0,4,4,4,0,5,7,0,3,1,3,4,4,15,3,4,4,4,4,4,4,4,4,4,4,4,4,7,4,4,4,4,7,2,7,4,10,7,4,4,4,4,4,4,4,2,4,4,4,4,4,4,4,4,4,4,4,4,1,4,4,4,4,0,4,4,4,4,4,2,4,4,4,4,4,4,4,4,4,4,4,4,4,4,4,4,4,4,4,4,4,4,4,4,4,4,4,4,4,4,4,4
4,4,4,4,0,4,4,4,14,4,6,3,4,5,7,4,4,4,4,7,4,3,4,4,7,2,4,7,4,4,4,4,4,4,4,4,4,4,4,4,4,4,4,4,4,4,5,12,4,4,4,4,4,4,4,4,6,5,0,2,7,3,3,1,4,7,4,4,4,4,4,4,4,4,4,7,4,4,4,4,6,4,4,4,4,4,5,4,4,4,4,4,4,4,4,4,4,4,4,4,4,4,4,4,4,4,4,4,4,4,4,4,4,4,4,4,4,4,4,4
4,4,4,4,6,4,4,4,2,4,7,2,4,2,5,4,4,4,4,11,4,0,2,6,3,0,2,15,9,1,0,1,4,4,4,4,4,4,4,4,4,4,4,4,4,4,4,4,0,4,4,4,4,4,4,4,4,4,4,4,4,4,4,6,10,4,4,4,4,4,4,4,4,4,4,9,4,4,4,4,0,4,4,4,4,4,0,4,4,4,4,4,4,4,4,4,4,4,4,4,4,4,4,4,4,4,4,4,4,4,4,4,4,4,4,4,4,4,4,4
4,4,4,4,10,4,4,4,2,4,0,4,4,8,3,4,4,4,4,4,4,4,4,4,4,2,4,4,4,4,4,4,2,0,6,4,3,3,7,4,4,4,4,4,4,4,4,4,4,0,14,4,4,4,4,4,4,4,4,4,5,7,1,6,7,4,4,4,4,4,4,4,4,4,4,7,4,4,4,14,4,4,4,4,4,6,4,4,4,4,4,4,4,4,4,4,4,4,4,4,4,4,4,4,4,4,4,4,4,4,4,4,4,4,4,4,4,4,4,4
4,4,4,4,4,4,4,4,5,4,7,4,5,4,7,4,4,4,4,4,4,4,4,1,14,2,12,4,4,4,4,4,4,4,4,4,4,4,11,14,6,1,4,4,4,4,4,4,4,4,4,7,0,4,4,6,3,9,4,2,4,4,11,4,4,4,4,4,4,4,4,4,4,4,4,3,4,4,4,15,4,4,4,4,4,0,4,4,4,4,4,4,4,4,4,4,4,4,4,4,4,4,4,4,4,4,4,4,4,4,4,4,4,4,4,4,4,4,4,4
4,4,4,4,4,4,4,4,2,6,14,7,4,7,14,0,7,5,0,2,9,4,2,4,6,4,12,3,2,4,4,4,4,4,4,4,4,4,4,4,4,4,4,3,4,1,2,0,1,5,7,7,3,8,4,4,4,4,4,4,4,4,4,4,4,4,4,4,4,4,4,4,4,4,4,2,4,4,5,4,4,4,4,4,14,4,4,4,4,4,4,4,4,4,4,4,4,4,4,4,4,4,4,4,4,4,4,4,4,4,4,4,4,4,4,4,4,12,2,7
4,4,4,4,4,4,4,4,2,13,4,7,15,4,4,6,4,4,0,4,10,2,7,7,1,7,8,2,4,6,6,7,7,1,4,4,4,4,4,4,4,4,4,4,4,4,4,4,4,4,4,4,4,4,4,4,1,4,4,4,4,4,4,4,4,4,4,4,4,4,4,4,4,4,4,7,4,6,4,4,4,4,4,4,5,4,4,4,4,4,4,4,4,4,4,4,4,4,4,4,4,4,4,4,4,4,4,4,4,4,4,4,4,3,4,4,13,4,4,4
4,4,4,4,4,4,4,4,1,1,4,4,12,4,4,7,4,6,4,4,9,6,4,4,4,4,4,4,4,4,1,12,1,4,6,2,5,6,10,0,9,4,4,4,4,4,4,4,4,4,4,4,4,4,4,4,4,5,0,3,2,3,4,4,4,4,4,4,4,4,4,4,4,4,6,4,0,4,4,4,4,4,4,1,4,4,4,4,4,4,4,4,4,4,4,4,4,4,4,4,4,4,4,4,4,4,4,4,4,4,5,3,2,4,4,4,4,4,4,4
4,4,4,4,4,4,4,3,7,4,4,4,14,4,4,3,5,4,4,3,4,4,4,4,4,4,4,1,4,5,7,6,12,4,4,4,4,4,4,4,4,9,12,7,4,4,4,4,4,4,4,4,4,4,4,4,4,4,4,7,14,6,6,2,4,4,4,4,4,4,4,4,4,4,3,6,4,4,4,4,4,4,4,2,4,4,4,4,4,4,4,4,4,4,4,4,4,4,4,4,4,4,4,4,4,4,6,10,0,1,4,4,4,4,4,4,4,4,4,4
4,4,4,4,4,4,4,3,7,4,4,4,6,4,4,0,6,4,7,4,4,4,4,4,4,4,3,4,4,4,4,4,4,5,3,4,4,4,4,4,4,4,4,4,5,5,5,3,4,4,4,4,4,4,4,4,4,4,4,12,4,4,4,4,5,11,4,4,4,4,4,4,4,3,4,4,4,4,4,4,4,4,2,4,4,4,4,4,4,4,4,4,4,4,4,4,4,4,4,4,4,4,4,9,1,2,4,4,4,4,4,4,4,4,4,4,4,4,4,4
4,4,4,4,4,4,4,4,4,4,4,4,14,4,5,4,6,4,4,4,4,4,3,5,12,2,4,4,4,4,4,4,4,4,4,3,5,4,4,4,4,4,4,4,4,4,4,4,5,14,2,4,4,4,4,4,4,4,4,1,4,4,4,4,4,4,1,6,0,0,10,11,6,4,2,4,4,4,4,4,4,4,1,4,4,4,4,4,4,4,4,4,4,4,4,4,4,4,4,5,12,7,4,4,4,4,4,4,4,4,4,4,4,4,4,4,4,4,4,4
4,4,4,4,4,4,4,4,4,4,4,4,4,7,6,12,3,0,6,9,6,5,4,4,4,4,4,4,4,4,4,4,4,4,4,4,4,2,0,4,4,4,4,4,4,4,4,4,4,4,4,0,2,5,4,4,4,4,4,14,0,4,4,4,4,4,4,5,2,6,7,0,3,5,4,3,3,3,9,11,0,2,13,1,5,2,10,12,8,5,6,4,3,0,1,5,0,2,4,4,4,4,4,4,4,4,4,4,4,4,4,4,4,4,4,4,4,4,4,4
4,4,4,4,4,4,4,4,4,4,4,4,5,4,4,4,4,4,4,4,4,4,4,4,4,4,4,4,4,4,4,4,4,4,4,4,4,4,4,3,7,4,4,4,4,4,4,4,4,4,4,4,4,4,3,0,4,4,4,4,4,0,3,0,2,13,2,4,4,4,4,4,4,4,2,4,4,4,4,4,10,4,4,4,4,4,4,4,4,4,4,4,4,4,4,4,4,4,4,4,4,4,4,4,4,4,4,4,4,4,4,4,4,4,4,4,4,4,4,4
